I
esse — zijn, fui
non — niet
enim — want
et — en, ook
cur — waarom
quoque — ook
sed — maar
neque…neque, nec…nec — noch…noch, niet… en ook niet
audire — horen, luisteren
omnis — geheel

II
omnes, omnia — allen, alles, alle
ubi — waar
femina — vrouw
autem — echter, maar
tum — dan, toen
dicere — zeggen, dixi
novus — nieuw
navis — schip, naves
mare — zee, maria
stare — staan, steti

III
etiam — ook, zelfs
nam — want
servus — slaaf
serva — slavin
videre — zien, vidi
dea — godin
mater — moeder, matres
urbs — stad, urbes
quid — wat, waarom
facere — doen, feci

IV
iam — al, reeds
in +acc — in, naar (binnen in)
in +abl — in, op
ad +acc — naar, bij
deus — god
magnus — groot
ita — zo
ibi — daar
posse — kunnen, potui
caput — hoofd, capita

V
vocare — roepen, noemen
venire — komen, veni
-ne — achtervoegsel geeft aan dat er een vraagzin volgt, niet vertalen
quis — wie
vos — jullie
is, ea, id — die, deze, hij, zij het
tu — jij, je, u
ego — ik
homo — man, mens, homines
vir — man, viri

VI
filius — zoon
ire — gaan, ii
ferre — dragen, brengen, tuli
nunc — nu
petere — (op)zoeken, vragen, aanvallen, (op weg) gaan naar
amor — liefde, amores
mons — berg, montes
inter +acc — tussen
-que — en achtervoegsel
alii..alii — sommigen…anderen

VII
dare — geven, dedi
movere — bewegen, movi
post +acc — na, achter
nox — nacht, noctes
multus — veel
nos — wij
habere — hebben, habui
pater — vader, patres
sic — zo
cognoscere — leren kennen, inzien, vernemen, cognovi

VIII
cupere — willen, verlangen
tamen — toch
capere — (in)nemen, pakken, grijpen, vangen, cepi
ceteri — overige(n)
a, ab +abl — vanaf, weg van
de +abl — vanaf, van … af, over
an — of in: vragen of
ducere — leiden, brengen, duxi
cum +abl — samen met
cum +ind — wanneer, als, toen

IX
e, ex +abl — uit, sinds
credere — geloven, credidi
numquam — nooit
miles — soldaat, milites
ecce — kijk
sine +abl — zonder
mors — (de) dood, mortes
modus — manier
tandem — ten slotte, eindelijk
ille, illa, illud — hij, zij, het, die, dat, deze, dit

X
atque, ac — en, en ook
bonus — goed
unus — één
tenere — vasthouden, vasthebben, bezetten, tenui
meus — mijn
os — mond, gezicht, ora
hic — hier
ipse, ipsa, ipsum — zelf
suus — zijn, haar, hun
noster — ons, onze

XI
nullus — geen
hic, haec, hoc — hij, zij, het, dit, deze
vester — jullie, uw
longus — lang
vale — vaarwel, doei
solus — alleen
tuus — jouw, uw
adhuc — nog, nog steeds
num — toch zeker niet
semper — altijd

XII
duo — twee
causa — reden, oorzaak
adesse — aanwezig zijn, adfui
ut — zoals, zodra
aqua — water
dux — leider, duces
malus — slecht
totus — (ge)heel
tunc — dan, toen, vervolgens
nemo — niemand

XIII
pro +abl — voor
quia — omdat
quod — omdat
nisi — als niet, tenzij, behalve
dum — terwijl, zolang als
si — als, indien
postquam — nadat
iste, ista, istud — hij, zij, het, die, dat, deze, dit
sicut — zoals
qui, quae, quod — die, dat betr vnw, wie, welk(e) vr vnw
